0 0 0 0 0 0 0 0 0 0 0 0 0 0 0 0 0 0 0 0 0 0 
0 135 135 135 135 135 135 135 135 135 135 135 135 135 135 135 135 135 135 135 135 0 
0 135 0 0 135 135 135 135 135 135 135 135 135 135 135 135 135 135 135 135 135 0 
0 135 0 0 135 135 135 30 31 30 31 30 31 30 31 135 135 135 135 135 135 0 
0 135 23 24 135 135 135 23 24 23 24 23 24 23 24 135 135 135 135 135 135 0 
0 135 30 31 135 135 135 135 135 135 135 135 135 30 31 135 135 135 135 135 135 0 
0 135 23 24 23 24 23 24 23 24 23 24 23 24 23 24 23 24 135 135 135 0 
0 135 30 31 30 31 30 31 30 31 30 31 30 31 30 31 30 31 135 135 135 0 
0 135 135 135 23 24 23 24 23 24 23 24 23 24 23 24 23 24 135 135 135 0 
0 135 135 135 30 31 30 31 30 31 30 31 30 31 30 31 30 31 135 135 135 0 
0 135 135 135 23 24 23 24 23 24 23 24 23 24 23 24 23 24 135 135 135 0 
0 135 135 135 30 31 30 31 30 31 30 31 30 31 30 31 30 31 135 135 135 0 
0 135 135 135 23 24 23 24 23 24 23 24 23 24 23 24 23 24 135 135 135 0 
0 135 135 135 30 31 30 31 30 31 30 31 30 31 30 31 30 31 135 135 135 0 
0 135 135 135 23 23 135 135 135 135 135 135 135 135 23 24 135 135 135 135 135 0 
0 135 135 135 30 30 30 31 31 135 135 135 30 31 30 31 30 31 135 135 135 0 
0 135 135 135 23 23 24 23 24 135 135 135 23 24 23 24 23 24 135 135 135 0 
0 135 135 135 30 30 31 30 31 135 135 135 30 31 30 31 30 31 135 135 135 0 
0 135 135 135 23 23 24 23 24 135 135 135 23 24 23 24 23 24 135 135 135 0 
0 135 135 135 135 135 135 135 135 135 135 135 135 135 135 135 135 135 135 135 135 0 
0 135 135 135 135 135 135 135 135 135 135 135 135 135 135 135 135 135 135 135 135 0 
0 0 0 0 0 0 0 0 0 0 0 0 0 0 0 0 0 0 0 0 0 0