0 0 0 0 0 0 0 0 28 28 0 0 0 0 0 0 0 0 0 0 0 0 
0 124 124 124 124 124 124 125 0 0 123 124 124 124 124 124 124 124 124 124 124 0 
0 124 124 124 124 124 124 125 0 0 123 124 124 124 124 124 124 124 124 124 124 0 
0 124 124 124 124 124 124 125 0 0 123 124 124 124 41 124 124 124 124 124 131 0 
0 124 124 124 131 131 131 132 0 0 130 131 131 131 0 131 131 131 131 132 37 0 
0 124 124 125 0 0 0 0 0 0 0 0 0 144 0 144 0 0 31 22 23 0 
0 124 124 132 0 24 26 0 0 22 23 0 0 0 0 0 0 0 0 29 30 0 
0 124 125 0 0 0 33 0 0 29 30 0 0 0 0 0 0 0 26 24 100 0 
0 124 125 0 0 0 40 0 0 0 0 0 0 0 0 0 0 0 33 97 107 0 
0 124 132 0 0 0 0 0 0 0 0 0 0 0 0 0 0 0 40 101 109 0 
0 107 95 0 0 0 0 0 0 0 0 0 0 0 0 0 0 0 101 108 109 0 
0 109 95 0 0 0 0 0 0 0 0 0 0 0 0 0 0 97 108 109 109 0 
0 109 22 23 0 0 0 0 0 0 31 0 0 0 0 0 0 97 137 109 109 0 
0 5 29 30 0 0 0 0 0 0 0 0 0 22 23 0 0 0 90 109 109 0 
0 15 4 5 0 0 22 23 0 0 0 0 0 29 30 0 0 0 97 109 109 0 
0 13 13 12 0 0 29 30 0 0 0 0 26 0 0 0 0 0 0 90 109 0 
0 13 13 15 5 0 0 0 0 0 0 0 33 0 0 0 0 0 0 97 109 0 
0 13 13 13 15 4 5 0 0 0 0 0 40 0 0 0 0 0 0 97 109 0 
0 13 13 13 13 13 15 4 4 4 4 5 0 0 3 4 5 0 0 0 89 27 
0 13 13 13 13 13 13 13 13 13 13 15 4 5 10 13 15 4 5 0 0 27 
0 13 13 13 13 13 13 13 13 13 13 13 13 15 16 13 13 13 15 4 5 0 
0 0 0 0 0 0 0 0 0 0 0 0 0 0 0 0 0 0 0 0 0 0