0 0 0 0 0 0 0 0 0 0 0 0 0 0 0 0 0 0 0 0 0 0 
34 17 18 18 18 18 18 18 18 19 26 3 4 4 4 4 5 10 11 26 0 0 
41 0 0 0 0 0 26 0 0 34 33 10 11 11 11 11 12 17 18 33 0 0 
34 23 0 0 0 0 33 0 0 0 40 17 18 18 18 18 19 0 0 3 4 0 
0 30 0 0 0 0 40 0 0 0 0 0 0 0 24 0 0 0 0 10 11 0 
0 24 0 0 0 0 0 0 0 0 0 0 0 0 0 0 0 0 0 17 18 0 
0 4 5 0 0 31 0 0 0 0 0 0 0 26 0 0 0 0 0 3 4 0 
0 11 12 0 0 0 0 0 0 0 0 0 0 33 0 0 0 0 0 10 11 0 
0 18 19 0 0 0 0 24 0 26 0 0 0 40 0 0 0 0 0 17 22 0 
0 5 0 0 0 0 0 0 0 33 0 0 0 0 0 0 0 0 0 0 29 0 
0 12 3 4 5 0 0 0 0 40 0 0 0 0 26 0 0 0 0 0 24 0 
34 19 10 11 12 0 0 0 0 0 0 0 0 0 33 0 0 0 0 0 3 0 
27 0 17 18 19 0 0 0 0 0 0 0 0 0 40 0 0 31 0 0 10 0 
27 0 0 0 0 0 0 26 0 0 0 0 0 0 0 0 0 0 0 0 17 34 
34 31 26 0 0 0 0 33 0 0 0 0 0 0 0 0 0 0 0 0 0 28 
0 5 33 0 31 0 0 40 0 0 0 0 24 0 0 0 0 0 26 0 3 34 
0 12 40 0 0 0 0 0 0 0 0 26 0 0 0 0 0 0 33 0 10 0 
0 4 5 0 0 0 0 0 0 0 0 33 0 0 0 0 0 0 40 0 17 0 
0 11 12 0 0 0 0 0 0 0 0 40 0 0 0 0 0 0 0 0 3 0 
0 18 19 0 0 0 0 0 0 0 0 0 0 0 0 0 0 0 0 0 10 0 
0 3 4 4 4 4 4 4 4 4 4 4 4 4 4 4 4 4 4 4 16 0 
0 0 0 0 0 0 0 0 0 0 0 0 0 0 0 0 0 0 0 0 0 0