0 0 0 0 0 0 0 0 0 0 0 0 0 0 0 0 0 0 0 0 0 0 
0 109 109 95 22 23 0 0 0 3 4 0 0 0 0 0 0 0 0 0 0 0 
0 0 0 95 29 30 0 0 25 0 0 0 0 0 0 0 0 0 0 0 0 0 
0 37 37 0 3 0 0 0 0 0 0 0 0 0 0 0 0 0 0 0 0 0 
0 37 37 0 0 0 0 0 0 0 0 0 0 0 0 0 0 0 0 0 0 0 
0 0 0 4 0 0 0 0 0 0 0 0 0 0 0 0 0 0 0 0 0 0 
0 0 0 0 0 0 0 0 0 0 0 0 0 0 0 18 19 0 0 0 0 0 
0 0 0 0 0 0 0 0 0 0 0 0 0 0 0 0 0 0 0 0 0 0 
0 0 0 0 0 0 0 0 0 0 0 0 0 0 0 0 0 0 0 0 0 0 
0 0 0 0 0 0 0 0 0 0 0 0 0 0 0 0 0 0 0 0 0 0 
0 0 0 0 0 0 0 0 0 0 0 0 0 0 0 0 25 0 0 0 0 0 
0 0 0 0 0 0 0 0 0 5 0 0 0 0 0 0 0 0 0 0 0 0 
0 0 0 0 0 0 0 0 13 13 11 0 0 0 0 85 0 0 0 0 0 0 
0 18 18 0 0 0 0 0 0 0 18 19 0 0 0 0 0 0 0 0 0 0 
0 0 0 17 18 0 0 0 0 0 0 0 0 0 0 0 105 0 0 0 0 0 
0 107 37 22 23 0 0 0 0 0 0 0 0 0 0 0 119 0 0 0 0 0 
0 109 95 29 30 0 0 0 0 0 0 0 0 0 0 0 0 0 17 13 13 0 
0 109 99 100 100 25 0 37 0 0 0 0 0 0 0 0 0 0 0 13 0 0 
0 109 106 107 107 92 22 23 0 0 0 0 0 0 0 0 0 0 0 13 0 0 
0 109 109 109 109 99 29 30 0 0 0 0 0 0 0 0 0 0 0 13 0 0 
0 109 109 109 109 106 92 0 0 25 0 0 0 0 0 0 0 0 0 0 0 0 
0 0 0 0 0 0 0 0 0 0 0 0 0 0 0 0 0 0 0 0 0 0