0 0 0 0 0 0 0 0 0 0 0 0 0 0 0 0 0 0 0 0 0 0 
0 37 38 37 38 0 0 0 0 0 0 0 0 0 0 0 0 0 0 0 0 0 
0 25 75 76 22 0 10 38 37 37 38 37 38 37 38 10 0 0 0 0 0 0 
0 32 41 41 29 0 32 0 0 0 0 0 0 0 0 29 0 0 0 0 0 0 
0 25 0 0 29 0 32 0 0 0 0 0 0 0 0 22 0 0 0 0 0 0 
0 32 0 0 36 37 38 37 38 37 38 37 38 38 0 36 37 38 3 0 0 0 
0 25 0 0 0 0 0 0 0 0 0 0 0 0 0 0 0 0 22 0 0 0 
0 32 0 0 0 0 0 0 0 0 0 0 0 0 0 0 0 0 29 0 0 0 
0 16 17 18 0 0 0 0 0 0 0 0 0 0 0 0 0 0 22 0 0 0 
0 0 0 25 0 0 0 0 0 0 0 0 0 0 0 0 0 0 29 0 0 0 
0 0 0 25 0 0 0 0 0 0 0 0 0 0 0 0 0 0 22 0 0 0 
0 0 0 25 0 0 0 0 0 0 0 0 0 0 0 0 0 0 29 0 0 0 
0 0 0 25 0 0 0 0 0 0 0 0 0 0 0 0 0 0 22 0 0 0 
0 0 0 25 0 0 0 0 0 0 0 0 0 0 0 0 0 0 29 0 0 0 
0 0 0 25 0 3 16 3 17 16 17 16 17 18 0 1 15 17 10 0 0 0 
0 0 0 25 0 0 0 0 0 10 10 10 0 0 0 0 0 0 10 0 0 0 
0 0 0 25 0 0 0 0 0 22 10 10 0 0 0 0 0 0 22 0 0 0 
0 0 0 25 0 0 0 0 0 22 10 25 0 0 0 0 0 0 22 0 0 0 
0 0 0 32 0 0 0 0 0 29 10 32 0 0 0 0 0 0 29 0 0 0 
0 0 0 10 16 17 17 16 17 11 11 10 16 16 16 16 16 17 10 0 0 0 
0 0 0 0 0 0 0 0 0 0 0 0 0 0 0 0 0 0 0 0 0 0 
0 0 0 0 0 0 0 0 0 0 0 0 0 0 0 0 0 0 0 0 0 0