0 0 0 0 0 0 0 0 0 0 0 0 0 0 0 0 0 0 0 0 0 0 
0 13 13 13 13 13 13 13 13 11 2 1 13 13 13 13 13 13 13 13 13 0 
0 13 13 13 13 13 1 11 26 8 18 9 2 1 2 13 13 13 13 13 13 0 
0 13 13 13 13 13 15 8 33 19 0 17 18 9 16 13 13 13 13 13 13 0 
0 13 13 13 13 13 21 12 40 0 0 0 0 10 11 11 11 11 11 11 11 0 
0 13 13 13 13 1 11 12 0 0 0 0 0 17 18 18 18 18 18 18 9 0 
0 13 1 2 1 8 18 19 0 26 0 0 0 0 26 0 0 0 0 0 17 0 
0 13 8 18 18 19 0 0 0 33 0 0 0 0 33 0 0 0 0 0 24 0 
0 11 12 0 0 0 31 0 0 40 34 34 34 34 40 0 0 0 3 4 4 0 
0 18 19 0 0 0 0 0 0 26 0 0 0 34 26 0 0 0 10 21 35 0 
0 34 0 0 0 0 0 0 0 33 0 0 0 34 33 22 23 0 10 21 35 0 
0 4 5 0 0 0 0 0 0 40 34 34 34 34 40 29 30 0 10 21 35 0 
0 11 12 0 0 0 0 0 0 0 0 0 0 0 0 0 0 0 10 21 35 0 
34 18 19 0 0 0 0 0 0 0 0 0 3 4 4 4 4 4 16 13 13 0 
27 0 0 0 0 0 0 24 0 0 0 0 10 11 11 11 11 11 11 2 13 0 
27 0 0 0 0 0 0 0 3 4 4 4 16 15 16 15 16 15 16 15 13 0 
34 4 4 4 4 4 4 5 10 11 11 11 11 11 2 13 13 13 13 13 13 0 
0 13 13 13 13 13 13 15 16 15 16 15 16 15 16 13 13 13 13 13 13 0 
0 13 13 13 13 13 13 13 13 13 13 13 13 13 13 13 13 13 13 13 13 0 
0 13 13 13 13 13 13 13 13 13 13 13 13 13 13 13 13 13 13 13 13 0 
0 13 13 13 13 13 13 13 13 13 13 13 13 13 13 13 13 13 13 13 13 0 
0 0 0 0 0 0 0 0 0 0 0 0 0 0 0 0 0 0 0 0 0 0