0 0 0 0 0 0 0 0 0 0 0 0 0 0 0 0 0 0 0 0 0 0 
0 109 109 109 109 109 109 109 109 109 109 109 109 109 109 109 109 109 109 109 109 0 
0 109 109 109 109 109 109 109 109 109 109 109 109 109 109 109 109 109 109 109 109 0 
0 109 109 109 109 109 109 109 109 109 109 109 109 109 109 109 25 109 109 109 109 0 
0 109 109 109 109 109 109 109 88 89 89 89 89 89 90 109 109 109 109 109 109 0 
0 109 109 109 109 109 109 88 96 96 96 96 96 96 94 109 109 109 109 109 109 0 
0 109 109 109 109 88 89 95 96 85 86 86 87 96 94 89 90 109 109 109 109 0 
0 109 109 109 109 95 96 95 96 92 93 93 94 96 94 96 97 109 109 109 109 0 
0 109 109 109 109 102 103 95 96 99 93 93 97 96 94 96 97 109 109 109 109 0 
0 109 109 109 109 106 107 95 96 130 99 100 101 96 97 96 96 90 109 109 109 0 
0 109 109 109 109 109 109 95 96 93 130 142 132 93 97 96 103 104 109 109 109 0 
0 109 109 109 109 109 109 99 96 93 100 100 100 100 104 107 107 108 109 109 109 0 
0 109 109 109 109 109 109 123 149 149 124 124 124 124 125 109 109 109 109 109 109 0 
0 109 109 109 109 109 109 106 142 142 107 107 107 107 108 109 109 109 109 109 109 0 
0 23 109 109 109 88 89 89 93 97 109 109 109 109 109 109 109 109 109 109 109 0 
0 30 89 89 89 96 96 96 96 93 89 90 109 109 109 109 109 88 3 4 5 0 
0 4 5 0 0 0 0 0 0 0 0 0 89 89 89 89 89 0 10 11 12 0 
0 13 15 5 4 5 0 0 0 0 0 0 0 3 4 5 0 0 17 18 19 0 
0 13 1 12 13 15 4 5 4 5 0 0 0 10 11 3 4 5 4 5 4 0 
0 13 15 16 13 13 13 13 13 15 4 5 0 3 4 10 11 12 13 13 13 0 
0 13 13 13 13 13 13 13 13 13 13 12 0 10 11 12 15 16 13 13 13 0 
0 0 0 0 0 0 0 0 0 0 0 0 27 0 0 0 0 0 0 0 0 0