0 0 0 0 0 0 0 0 0 0 0 0 0 0 0 0 0 0 0 0 0 0 
0 0 0 0 0 0 0 0 0 0 0 0 0 0 0 0 0 0 0 0 0 0 
0 0 0 0 0 13 13 13 13 0 0 0 0 17 13 0 0 0 0 0 0 0 
0 0 0 0 13 13 13 0 18 0 37 0 37 0 0 13 0 13 13 0 0 0 
0 0 0 0 13 11 12 0 0 0 0 0 37 0 0 10 11 16 13 0 0 0 
0 0 0 0 0 18 19 37 0 0 0 0 0 37 0 17 18 0 0 0 19 0 
0 0 0 13 13 12 0 0 0 0 0 0 0 0 0 0 0 0 0 0 0 0 
0 0 0 13 0 0 0 0 0 0 37 37 0 0 0 4 5 0 0 0 17 0 
0 13 13 17 0 0 0 0 0 0 0 37 37 0 0 11 12 0 0 0 0 0 
0 13 0 0 37 0 0 0 0 0 0 0 0 0 0 18 13 13 0 0 137 0 
0 0 0 19 0 0 37 0 0 0 0 0 37 37 0 0 0 10 11 12 0 0 
0 0 0 0 0 0 37 37 0 0 0 0 37 0 0 0 0 17 18 19 13 0 
0 0 0 0 13 0 0 0 0 0 0 0 0 0 0 0 37 37 0 0 18 0 
0 0 0 0 13 0 0 0 0 0 0 0 0 0 0 0 0 0 0 0 16 0 
0 0 0 0 0 18 0 0 0 0 0 0 0 0 0 0 0 0 0 0 13 0 
0 0 0 0 0 0 0 0 0 0 0 0 0 0 0 0 0 0 0 18 2 0 
0 0 0 0 0 0 0 0 0 0 0 0 0 0 0 0 0 0 0 0 0 0 
0 17 0 0 0 0 0 0 0 0 0 0 0 0 0 0 0 0 0 0 18 0 
0 0 0 0 0 0 0 0 0 0 0 0 0 0 0 0 0 0 0 0 0 0 
0 0 0 0 0 0 0 0 0 0 0 0 0 0 0 0 0 0 0 25 17 0 
0 0 0 0 0 0 0 0 0 0 0 0 0 0 0 0 0 0 0 0 0 0 
0 0 0 0 0 0 0 0 0 0 0 0 0 0 0 0 0 0 0 0 0 0