135 135 135 135 135 135 135 135 135 135 135 135 135 135 135 135 135 135 135 135 135 135 
135 135 135 135 135 135 135 135 135 135 135 135 135 135 135 135 135 135 135 135 135 135 
135 135 135 135 135 135 135 135 135 135 135 135 135 135 135 135 135 135 135 135 135 135 
135 135 135 23 24 135 135 135 135 135 135 135 135 135 135 135 135 135 135 135 135 135 
135 135 135 23 24 135 135 135 135 135 135 135 135 135 135 135 135 135 135 135 135 135 
135 135 135 23 23 23 24 24 24 23 24 135 135 135 135 135 135 135 135 135 135 135 
135 135 135 23 24 24 24 24 24 24 24 135 135 135 135 135 135 135 135 135 135 135 
135 135 135 135 135 135 135 135 23 24 24 135 135 135 135 135 135 135 135 135 135 135 
135 135 135 135 135 135 135 135 23 23 24 135 135 135 135 135 135 135 135 135 135 135 
135 135 135 135 135 135 135 135 23 24 135 135 135 135 135 135 135 135 135 135 135 135 
135 135 135 135 135 135 135 135 23 24 135 135 135 135 135 135 135 135 135 135 135 135 
135 135 135 135 135 135 135 135 23 24 23 23 23 23 23 23 23 24 135 135 135 135 
135 135 135 135 135 135 135 135 23 24 24 24 24 24 24 24 23 24 135 135 135 135 
135 135 135 135 135 135 135 135 135 135 135 135 135 135 135 135 23 24 135 135 135 135 
135 135 135 135 135 135 135 135 135 135 135 135 135 135 135 135 23 24 135 135 135 135 
135 135 135 135 135 135 135 135 135 135 135 135 23 24 24 23 23 23 23 135 135 135 
135 135 135 135 135 135 135 135 135 135 135 135 23 24 24 23 23 23 23 135 135 135 
135 135 135 135 135 135 135 135 135 135 135 135 23 24 24 24 24 24 23 135 135 135 
135 135 135 135 135 135 24 23 24 24 23 24 23 24 24 24 24 24 23 135 135 135 
135 135 135 135 135 135 23 24 24 23 24 24 23 23 24 24 23 24 30 135 135 135 
135 135 135 135 135 135 135 135 135 135 135 135 135 135 135 135 135 135 135 135 135 135 
135 135 135 135 135 135 135 135 135 135 135 135 135 135 135 135 135 135 135 135 135 135