0 0 0 0 0 0 0 0 0 0 0 0 0 0 0 0 0 0 0 0 0 0 
0 7 7 7 7 7 7 7 7 7 7 7 7 7 7 7 7 7 7 7 7 0 
0 7 7 7 7 7 7 7 7 7 7 7 7 7 7 7 7 7 7 7 7 0 
0 7 7 7 7 7 7 7 7 7 7 7 7 7 7 7 7 7 7 7 7 0 
0 7 7 7 7 7 7 7 7 7 7 7 7 7 7 7 7 7 7 7 7 0 
0 7 7 7 7 7 7 7 7 7 7 7 7 7 7 7 7 7 7 7 7 0 
0 7 7 7 7 7 7 7 7 7 7 7 7 7 7 7 7 7 7 7 7 0 
0 7 7 7 7 7 7 7 7 7 7 7 7 7 7 7 7 7 7 7 7 0 
0 7 7 7 7 7 7 7 7 7 7 7 7 7 7 7 7 7 7 7 7 0 
0 7 7 7 7 7 7 7 7 7 7 7 7 7 7 7 7 7 7 7 7 0 
0 7 7 7 7 7 7 7 7 7 7 7 7 7 7 7 7 7 7 7 7 0 
0 7 7 7 7 7 7 7 7 7 7 7 7 7 7 7 7 7 7 7 7 0 
0 7 95 7 7 7 7 7 7 7 7 7 7 7 7 7 7 7 7 7 7 0 
0 89 7 7 7 7 7 7 7 7 7 7 7 7 7 7 7 7 7 7 7 0 
0 7 7 7 7 7 7 7 7 7 7 7 7 7 7 7 7 7 7 7 7 0 
0 7 7 7 7 7 7 7 7 7 7 7 7 7 7 7 7 7 7 7 7 0 
0 7 7 7 7 7 7 7 7 7 7 7 7 7 7 7 7 7 7 7 7 0 
0 7 7 7 7 7 7 7 7 7 7 7 7 7 7 7 7 7 7 7 7 0 
0 7 7 7 7 7 7 7 7 7 7 7 7 7 7 7 7 7 7 7 7 0 
0 7 7 7 7 7 7 7 7 7 7 7 7 7 7 7 7 7 7 7 7 0 
0 7 7 7 7 7 7 7 7 7 7 7 7 7 7 7 7 7 7 7 7 0 
0 0 0 0 0 0 0 0 0 0 0 0 0 0 0 0 0 0 0 0 0 0