0 0 0 0 0 0 0 0 0 0 0 0 0 0 0 0 0 0 0 0 0 0 
0 0 0 0 0 0 0 0 0 0 0 0 0 109 0 0 0 0 0 109 0 0 
0 0 0 0 0 0 0 0 0 0 0 0 0 109 0 109 0 0 0 109 0 0 
0 0 0 0 0 0 0 0 0 0 0 0 0 109 0 109 0 0 0 88 0 0 
0 0 0 0 0 0 0 0 0 0 0 0 0 88 0 89 0 89 0 0 0 0 
0 0 0 0 0 0 0 0 0 0 0 0 0 95 96 96 96 96 96 96 96 0 
0 0 0 0 0 0 0 0 0 0 0 0 0 95 96 96 0 0 0 0 0 0 
0 0 0 0 0 0 0 0 0 0 0 0 0 0 0 0 0 0 0 0 0 0 
0 0 0 0 0 0 0 0 0 0 0 0 0 96 0 0 0 96 96 96 96 0 
0 0 0 0 0 0 0 0 0 0 0 0 96 0 0 0 96 0 0 0 0 0 
0 0 0 0 0 0 0 0 0 0 0 0 0 0 0 0 0 0 0 96 0 0 
0 0 0 0 0 0 0 0 0 0 0 0 0 0 96 7 7 7 7 7 7 0 
0 0 0 0 0 0 0 0 0 0 0 0 96 0 7 7 7 7 7 7 7 0 
0 0 0 0 0 0 0 0 0 0 0 0 0 0 7 7 7 7 7 7 7 0 
0 0 0 0 0 0 0 0 0 0 0 0 0 0 95 7 7 7 103 0 0 0 
0 0 0 0 0 0 0 0 0 0 0 0 0 0 102 103 103 0 0 0 0 0 
0 0 0 0 0 0 0 0 0 0 0 0 0 0 0 0 0 0 0 0 0 0 
0 0 0 0 0 0 0 0 0 0 0 0 0 0 0 0 0 0 0 0 0 0 
0 0 0 0 0 0 0 0 0 0 0 0 0 0 0 0 0 0 0 0 0 0 
0 0 0 0 0 0 0 0 0 0 0 0 0 0 0 0 0 0 0 0 0 0 
0 0 0 0 0 0 0 0 0 0 0 0 0 0 0 0 0 0 0 0 0 0 
0 0 0 0 0 0 0 0 0 0 0 0 0 0 0 0 0 0 0 0 0 0