0 0 0 0 0 0 0 0 0 0 0 0 28 0 0 0 0 0 0 0 0 0 
0 13 13 13 13 13 13 13 21 11 1 12 0 10 13 13 13 13 13 1 2 0 
0 13 13 13 13 13 3 4 2 8 18 19 0 3 4 35 13 13 13 8 9 0 
0 13 13 13 3 4 10 11 12 19 0 0 0 10 2 3 4 5 3 16 15 0 
0 13 13 13 10 0 17 18 19 0 0 0 0 17 18 10 11 12 10 11 12 0 
0 13 13 13 15 5 0 0 144 0 0 22 23 0 0 17 18 19 17 18 3 0 
0 13 13 3 4 5 26 0 0 0 0 29 30 0 0 0 0 0 0 0 10 0 
0 13 13 10 11 12 33 0 3 4 5 0 0 0 3 4 4 4 5 0 3 0 
0 3 4 5 18 19 40 0 10 11 12 0 0 0 10 2 13 21 12 0 10 0 
0 10 11 12 0 0 0 0 17 18 19 0 0 0 17 9 35 13 15 5 17 0 
0 15 16 15 4 5 0 0 0 0 0 0 26 0 0 10 11 11 26 3 4 0 
0 13 13 13 21 12 0 22 23 0 0 0 33 0 0 17 18 19 33 10 11 0 
0 13 13 13 3 4 5 29 30 0 0 0 40 0 0 0 0 0 40 17 3 0 
0 13 13 13 10 11 12 144 0 0 0 0 0 0 3 4 5 0 3 4 5 0 
0 13 13 13 15 5 19 3 4 5 0 0 0 0 10 11 12 0 10 11 12 0 
0 13 13 1 11 12 0 10 11 12 0 0 0 0 17 18 19 0 17 3 4 0 
0 11 11 12 18 19 0 17 18 19 0 0 0 0 0 0 0 0 144 10 11 0 
0 19 18 19 0 144 0 0 0 0 0 0 0 85 86 86 87 0 0 17 3 0 
0 86 87 0 0 0 0 0 0 0 0 0 0 92 22 23 94 0 0 0 10 0 
0 22 23 86 86 87 0 0 0 0 85 86 86 0 29 30 94 0 0 0 0 0 
0 29 30 93 93 93 86 87 0 0 92 93 93 93 93 93 144 86 86 86 86 0 
0 0 0 0 0 0 0 0 27 27 0 0 0 0 0 0 0 0 0 0 0 0