135 135 135 135 135 135 135 135 135 135 135 135 135 135 135 135 135 135 135 135 135 135 
135 135 135 135 135 135 135 135 135 135 135 135 135 135 135 135 135 135 135 135 135 135 
135 135 135 135 135 135 135 135 135 135 135 135 135 135 135 135 135 135 135 135 135 135 
135 135 107 108 135 135 135 135 135 135 135 135 135 135 135 135 135 135 135 135 135 135 
135 135 114 115 135 135 135 135 135 135 135 135 135 135 135 135 135 135 135 135 135 135 
135 135 107 108 135 135 135 135 135 135 135 135 135 135 135 135 135 135 135 135 135 135 
135 135 114 115 135 135 135 135 135 135 135 135 135 135 135 135 135 135 135 135 135 135 
135 135 107 108 107 108 135 135 135 135 135 135 135 135 135 135 135 135 135 135 135 135 
135 135 114 115 114 115 135 135 135 135 135 107 108 107 108 135 135 135 135 135 135 135 
135 135 107 108 108 107 108 135 135 135 135 107 108 107 108 135 135 135 135 135 135 135 
135 135 114 115 115 114 115 135 135 135 135 107 108 107 108 135 135 135 135 135 135 135 
135 135 107 108 107 108 107 108 107 108 107 107 108 107 108 135 135 135 135 135 135 135 
135 135 114 115 114 115 114 115 114 115 114 114 115 114 115 135 135 135 135 135 135 135 
135 135 135 135 135 135 135 135 107 108 135 135 135 135 135 135 135 135 135 135 135 135 
135 135 135 135 135 135 135 135 114 115 135 135 135 135 135 135 135 135 135 135 135 135 
135 135 135 135 135 135 135 135 107 108 107 108 107 108 135 135 135 135 135 135 135 135 
135 135 135 135 135 135 135 135 114 115 114 115 114 115 135 135 135 135 135 135 135 135 
135 135 107 108 107 108 107 108 107 108 107 108 107 108 135 135 135 135 135 135 135 135 
135 135 114 115 114 115 114 115 114 115 114 115 114 115 135 135 135 135 135 135 135 135 
135 135 135 135 135 135 135 135 135 135 135 135 135 135 135 135 135 135 135 135 135 135 
135 135 135 135 135 135 135 135 135 135 135 135 135 135 135 135 135 135 135 135 135 135 
135 135 135 135 135 135 135 135 135 135 135 135 135 135 135 135 135 135 135 135 135 135