0 0 0 0 0 0 0 0 0 0 0 0 0 0 41 0 0 0 0 0 0 0 
0 116 117 117 117 117 117 117 117 117 117 117 117 117 142 117 117 117 117 117 118 0 
0 123 124 124 124 124 124 124 124 124 124 124 124 124 142 124 124 124 124 124 0 0 
0 123 124 124 124 124 124 124 124 124 124 124 124 124 142 124 124 124 124 124 26 0 
0 130 131 131 131 131 131 131 131 131 131 131 131 131 142 131 131 131 131 131 33 0 
0 4 5 0 0 0 0 0 0 0 0 0 0 0 0 0 0 0 0 0 40 0 
0 11 12 0 100 100 100 0 0 0 0 0 0 0 0 144 0 0 0 94 108 0 
0 18 19 97 106 107 108 99 0 0 0 0 0 0 0 0 0 0 26 94 109 0 
0 31 0 97 109 109 109 107 92 0 0 0 0 0 0 0 0 0 33 94 109 0 
0 5 0 97 109 109 109 109 92 0 0 0 0 0 0 0 0 103 40 101 109 0 
0 12 0 0 89 89 89 89 0 22 23 0 0 0 0 0 97 106 107 108 109 0 
0 19 103 103 103 103 103 103 0 29 30 0 0 0 26 0 97 109 109 109 109 0 
0 131 131 142 131 131 131 131 92 0 0 0 144 0 33 0 97 88 89 89 24 0 
0 144 0 0 0 0 0 0 92 26 0 0 0 0 40 100 101 0 0 3 4 0 
0 5 0 0 0 0 0 0 92 33 0 0 0 97 131 131 132 0 0 10 11 0 
0 12 0 0 0 0 0 0 99 40 103 103 103 104 0 0 0 0 0 17 9 0 
0 12 144 0 0 0 0 0 130 131 142 131 131 132 0 0 0 0 0 0 17 0 
0 15 5 0 0 0 0 0 0 0 0 0 0 0 0 0 144 0 0 0 0 28 
0 11 12 0 0 0 0 0 0 0 0 0 0 0 0 0 0 0 0 0 0 28
0 18 19 0 0 0 0 0 0 0 0 0 0 0 0 0 0 0 0 0 0 28 
0 4 4 4 4 4 4 5 0 3 4 4 4 4 4 4 4 4 4 4 4 0 
0 0 0 0 0 0 0 0 27 0 0 0 0 0 0 0 0 0 0 0 0 0