0 0 0 0 0 0 0 0 0 0 0 0 0 0 0 0 0 0 0 0 0 0 
0 0 0 0 0 0 0 37 0 3 0 16 13 13 13 13 13 13 13 13 13 0 
0 22 23 0 0 0 0 0 0 10 13 13 13 13 13 13 13 13 13 13 13 0 
0 29 30 0 3 4 4 4 4 16 13 13 13 13 13 13 13 13 13 13 13 0 
0 0 0 0 10 13 13 13 13 13 13 13 13 13 13 13 13 13 13 13 13 0 
0 4 4 4 16 13 13 13 13 13 13 13 13 13 13 13 13 13 13 13 13 0 
0 11 11 11 11 11 11 11 11 2 13 13 13 13 13 13 13 13 13 13 13 0 
0 18 18 18 18 18 18 18 18 9 11 11 11 2 13 13 13 13 13 13 13 0 
27 0 0 37 0 0 0 0 0 17 18 18 18 10 11 11 11 11 13 13 13 0 
27 0 0 0 0 0 0 0 37 0 0 0 0 17 18 18 18 10 11 2 13 0 
27 0 0 0 0 0 0 0 0 0 0 0 0 37 0 26 0 17 18 10 13 0 
0 4 4 4 4 4 4 4 4 3 4 5 0 0 0 33 0 0 0 10 35 0 
0 11 11 2 13 13 13 13 0 10 0 12 0 0 0 40 86 87 0 10 35 0 
0 18 18 9 11 11 2 13 13 15 4 5 0 0 0 99 93 101 0 10 35 0 
0 0 0 17 18 18 9 11 2 13 11 12 0 37 0 123 28 125 3 16 13 0 
0 0 0 0 0 0 17 18 9 35 15 16 4 5 0 130 0 132 10 13 13 0 
0 0 0 0 0 0 0 0 10 35 13 13 21 12 0 0 0 0 3 4 5 0 
0 0 0 0 0 0 0 0 10 11 2 13 13 15 4 4 4 4 4 5 15 0 
0 0 0 0 0 0 0 0 17 18 10 35 13 13 13 13 13 13 1 12 13 0 
0 0 0 0 0 0 0 0 0 0 10 11 2 13 13 13 13 13 15 16 13 0 
0 0 0 0 0 0 0 0 0 0 17 18 9 13 13 13 13 13 13 13 13 0 
0 0 0 0 0 0 0 0 0 0 0 0 0 0 0 0 0 0 0 0 0 0