0 0 0 0 0 0 0 0 0 0 0 0 0 0 0 0 0 0 0 0 0 0 
0 0 0 0 0 0 0 0 0 0 0 0 0 0 0 0 0 0 0 0 0 0 
0 0 0 41 41 0 0 0 0 0 0 0 0 0 0 0 0 0 0 0 0 0 
0 0 25 0 0 22 0 0 0 0 0 0 0 0 0 0 0 0 0 0 0 0 
0 0 32 0 0 36 37 38 37 38 37 8 0 0 0 0 0 0 0 0 0 0 
0 0 25 0 0 0 0 0 0 0 27 22 0 0 0 0 0 0 0 0 0 0 
0 0 32 0 0 0 0 0 0 0 0 29 0 0 0 0 0 0 0 0 0 0 
0 0 2 16 17 16 17 18 0 0 0 22 0 0 0 0 0 0 0 0 0 0 
0 0 0 0 0 0 0 32 0 19 14 29 0 0 0 0 0 0 0 0 0 0 
0 0 0 0 0 0 0 25 0 12 15 3 0 0 0 0 0 0 0 0 0 0 
0 0 0 0 0 0 0 32 0 19 36 37 37 37 37 37 37 38 8 0 0 0 
0 0 0 0 0 0 0 25 0 21 0 0 0 0 0 0 0 0 22 0 0 0 
0 0 0 0 0 0 0 32 0 0 0 0 0 0 0 0 0 0 22 0 0 0 
0 0 0 0 0 0 0 11 17 16 17 16 17 16 17 18 0 0 22 0 0 0 
0 0 0 0 0 15 16 17 17 16 17 11 38 38 38 39 0 0 36 8 0 0 
0 0 0 0 0 22 28 95 121 122 94 25 27 0 0 0 0 13 14 22 0 0 
0 0 0 0 0 29 62 109 89 90 106 32 0 0 0 0 0 0 21 29 0 0 
0 0 0 0 0 22 34 116 42 42 113 32 0 0 0 0 0 0 0 36 0 0 
0 0 0 0 0 29 0 0 0 0 0 0 0 20 0 0 0 0 0 22 0 0 
0 0 0 0 0 29 0 0 0 0 0 0 0 0 0 0 0 0 0 29 0 0 
0 0 0 0 0 36 16 17 16 17 16 17 16 17 17 17 17 17 17 15 0 0 
0 0 0 0 0 0 0 0 0 0 0 0 0 0 0 0 0 0 0 0 0 0