0 34 34 34 34 34 34 34 34 34 34 34 0 0 0 0 0 0 0 0 0 0 
0 40 89 89 89 89 89 89 89 89 90 109 109 109 109 109 109 109 109 109 109 0 
41 0 0 0 0 0 0 0 22 23 0 89 89 89 90 109 109 109 26 109 109 0 
0 4 5 0 0 0 0 0 29 30 0 0 0 0 94 109 85 86 33 109 109 0 
0 11 12 0 0 0 0 0 0 0 0 0 0 100 100 109 92 144 40 109 109 0 
0 18 19 0 103 103 103 103 103 0 0 0 101 131 132 109 99 100 101 109 109 0 
0 131 131 142 131 131 131 131 131 95 96 97 132 0 94 109 106 107 108 109 109 0 
0 24 0 0 0 0 0 0 0 102 103 104 0 0 0 89 90 109 109 109 109 0 
0 5 0 0 0 0 0 0 0 130 131 132 0 0 0 100 101 109 109 109 109 0 
0 12 0 0 0 0 0 26 0 0 0 0 0 0 94 109 109 109 109 109 109 0 
0 19 0 0 100 100 0 33 0 0 0 0 0 0 94 109 109 109 109 109 109 0 
0 144 0 97 107 107 99 40 0 0 0 0 0 0 148 149 149 149 149 149 149 28 
0 4 5 97 109 109 107 95 0 0 0 0 22 23 94 109 109 109 109 109 109 0 
0 26 12 97 109 109 109 95 0 0 0 0 29 30 94 109 109 109 109 109 109 0 
0 33 19 97 109 109 109 95 0 0 0 0 0 0 94 109 109 109 109 109 109 0 
0 40 0 97 109 109 109 0 0 0 0 0 0 0 94 109 109 109 109 109 109 0 
0 5 0 0 89 89 89 0 0 0 0 0 0 0 24 89 89 90 109 109 109 0 
0 15 4 5 0 22 23 0 0 0 0 0 0 85 87 0 26 97 109 109 109 0 
0 11 11 12 0 29 30 0 0 0 0 0 0 99 101 0 33 97 109 109 109 0 
0 18 18 19 103 103 103 103 103 0 103 103 103 130 132 0 40 144 109 109 109 0 
0 124 124 124 124 124 124 124 124 142 124 124 124 95 0 0 0 0 90 109 109 0 
0 0 0 0 0 0 0 0 0 27 0 0 0 34 34 34 34 34 34 34 34 0