0 0 0 0 0 0 0 0 0 0 0 0 0 0 0 0 0 0 0 0 0 0 
0 109 109 109 109 109 109 109 109 109 109 109 109 109 109 109 109 109 109 26 109 0 
0 109 109 109 109 109 109 109 109 109 109 109 109 26 109 26 109 109 109 33 109 0 
0 109 109 109 109 109 109 109 109 109 109 109 109 33 109 33 109 109 109 40 89 0 
0 109 109 109 109 109 109 109 109 109 109 109 109 40 89 40 89 37 89 96 96 0 
0 109 109 109 109 109 109 109 109 109 109 109 109 22 23 3 4 4 4 4 4 0 
0 109 109 109 109 109 109 109 109 109 109 109 109 29 30 10 11 2 13 13 13 0 
0 109 109 109 109 109 109 109 109 109 109 88 89 96 96 17 18 10 11 11 11 0 
0 109 109 109 109 109 109 109 109 109 109 95 96 37 96 96 96 17 18 18 18 0 
0 109 109 109 109 109 109 109 109 109 109 95 25 96 96 96 37 96 96 96 96 28 
0 109 109 109 109 109 109 109 109 109 109 95 96 96 96 96 96 96 96 37 96 28 
27 149 149 149 149 149 149 149 149 149 149 150 96 96 37 96 3 4 4 4 4 0 
0 109 109 109 109 109 109 109 109 109 109 92 25 96 96 3 16 1 11 11 11 0 
0 109 109 109 109 109 109 109 109 109 109 99 100 100 3 16 1 8 18 18 18 0 
0 109 109 109 109 109 109 109 109 109 109 106 107 107 10 11 8 19 37 100 100 0 
0 109 109 109 109 109 109 109 109 109 109 109 109 109 17 18 19 101 107 107 107 0 
0 109 109 109 109 109 109 109 109 109 109 109 109 109 106 107 107 108 109 109 109 0 
0 109 109 109 109 109 109 109 109 109 109 109 109 109 109 109 109 109 109 109 109 0 
0 109 109 109 109 109 109 109 109 109 109 109 109 109 109 109 109 109 109 109 109 0 
0 109 109 109 109 109 109 109 109 109 109 109 109 109 109 109 109 109 109 109 109 0 
0 109 109 109 109 109 109 109 109 109 109 109 109 109 109 109 109 109 109 109 109 0 
0 0 0 0 0 0 0 0 0 0 0 0 0 0 0 0 0 0 0 0 0 0