0 0 0 0 0 0 0 0 27 0 0 0 0 0 0 0 0 0 0 0 0 0
0 13 13 13 13 1 11 12 0 10 2 1 13 13 13 13 13 13 13 13 13 0
0 13 1 2 1 8 18 19 0 17 18 9 2 1 2 13 13 13 13 13 13 0
0 13 8 18 18 19 0 0 0 0 0 17 18 9 16 13 13 13 13 13 13 0
0 11 12 0 0 0 0 0 26 0 0 0 0 10 11 11 11 11 11 11 11 0
0 18 19 0 0 0 0 0 33 0 0 0 0 17 18 18 18 18 18 18 18 0
0 5 0 0 0 0 0 0 40 0 0 0 0 0 0 0 0 0 0 0 3 0
0 12 0 0 22 23 0 0 0 0 22 23 0 0 0 0 0 0 0 0 10 0
0 12 0 0 29 30 0 0 0 0 29 30 0 0 0 0 0 0 0 0 17 0
0 12 0 0 0 0 0 0 31 0 0 0 0 0 0 0 0 0 0 26 3 0
0 12 0 0 0 0 0 0 0 0 0 0 0 3 4 5 0 0 0 33 10 0
0 12 0 0 0 0 0 0 0 0 0 0 0 10 11 12 0 0 0 40 17 0
0 12 0 0 0 0 0 22 23 0 0 0 0 17 18 19 0 0 0 0 0 28
0 12 0 0 0 0 0 29 30 0 0 0 0 0 0 0 0 0 0 3 4 0
0 12 0 0 0 0 0 0 0 0 0 0 0 0 0 0 0 0 0 10 13 0
0 12 0 0 0 0 0 0 0 0 0 0 26 0 0 3 4 4 4 16 13 0
0 12 0 0 26 0 0 0 0 0 0 0 33 0 0 10 11 11 11 11 2 0
0 12 0 0 33 0 0 0 0 0 0 0 40 0 0 17 18 18 18 18 9 0
0 12 0 0 40 0 0 0 0 0 0 0 0 0 0 0 0 0 0 0 10 0
0 12 0 0 0 0 0 0 0 0 0 0 0 0 0 0 0 0 0 0 10 0
0 15 4 4 4 4 4 4 5 0 3 4 4 4 4 4 4 4 4 4 16 0
0 0 0 0 0 0 0 0 0 34 0 0 0 0 0 0 0 0 0 0 0 0