0 0 0 0 0 0 0 0 0 0 0 0 0 0 0 0 0 0 0 0 0 0
0 13 13 13 13 13 13 13 13 13 13 13 13 13 13 13 13 13 13 13 13 0
0 13 13 13 13 13 13 13 13 13 13 13 13 13 13 13 13 13 13 13 13 0
0 13 13 13 13 13 13 13 13 13 13 13 13 13 13 13 13 13 13 13 13 0
0 13 13 13 13 13 13 13 13 13 13 13 13 13 13 13 13 13 13 13 13 0
0 13 13 13 13 13 13 13 13 13 13 13 13 13 13 13 13 13 13 13 13 0
0 13 13 13 13 13 13 13 13 13 13 13 13 13 13 13 13 13 13 13 13 0
0 13 13 13 13 13 13 13 13 13 13 13 13 13 13 13 13 13 13 13 13 0
0 11 11 11 2 13 13 13 13 13 13 13 13 13 13 13 13 13 13 13 13 0
0 18 18 18 9 13 13 13 13 13 13 13 13 13 13 13 13 13 13 13 13 0
0 0 0 0 10 11 11 11 11 12 27 10 11 11 11 2 13 13 13 13 13 0
0 84 0 0 17 18 18 18 18 19 0 17 18 18 18 9 13 13 13 13 13 0
0 0 0 0 0 0 0 84 0 0 0 0 84 0 0 10 13 13 13 13 13 0
0 0 0 0 0 0 0 0 0 0 0 0 0 0 0 10 11 11 11 11 11 0
0 0 0 0 0 0 0 0 0 0 0 0 0 0 0 17 18 18 18 18 18 0
0 0 0 0 0 0 0 0 0 0 0 0 0 0 0 0 0 0 0 0 0 0
0 0 84 0 0 0 0 0 0 0 0 0 0 0 0 0 0 0 0 0 0 0
0 0 0 0 0 0 0 0 0 0 0 0 0 0 0 0 0 0 0 0 0 0
0 0 0 0 0 0 0 0 0 0 0 0 0 0 0 0 0 0 84 0 0 0
0 0 0 0 0 0 0 0 0 0 0 0 0 0 0 0 0 0 0 0 0 0
0 0 0 0 0 0 0 0 0 0 0 0 0 0 0 0 0 0 0 0 0 0
0 0 0 0 0 0 0 0 0 0 0 0 0 0 0 0 0 0 0 0 0 0 0