0 95 121 122 94 0 0 0 0 0 0 0 0 0 0 0 0 0 0 0 0 0 
0 109 89 90 106 0 0 0 0 0 0 0 0 0 0 0 0 0 0 0 0 0 
0 116 42 42 113 0 0 0 0 0 0 0 0 0 0 0 0 0 0 0 0 0 
0 109 0 0 106 0 0 0 0 0 95 121 122 121 122 94 0 0 0 0 0 0 
0 116 0 0 113 0 0 0 0 0 109 47 48 49 77 106 0 0 0 0 0 0 
0 109 0 0 106 0 0 0 0 0 116 54 55 56 84 113 0 0 0 0 0 0 
0 116 0 0 120 121 94 0 0 0 109 61 62 63 91 106 0 0 0 0 0 0 
0 109 0 0 0 0 106 0 0 0 116 68 69 70 98 113 0 0 0 0 0 0 
0 116 0 0 0 0 99 94 0 0 109 0 0 0 0 106 0 0 0 0 0 0 
0 109 0 0 0 0 0 106 0 0 116 0 0 0 0 113 0 0 0 0 0 0 
0 116 0 0 0 0 0 99 121 122 86 0 0 0 0 106 0 0 0 0 0 0 
0 109 14 12 0 0 0 0 0 0 0 0 0 0 0 113 0 0 0 0 0 0 
0 116 21 19 6 6 12 0 0 0 0 0 0 0 20 106 0 0 0 0 0 0 
0 88 100 101 100 101 100 86 0 0 85 101 101 101 101 87 0 0 0 0 0 0 
0 95 121 122 94 12 5 93 0 0 92 122 121 122 94 0 0 0 0 0 0 0 
0 109 89 90 106 19 14 116 0 0 0 0 0 0 106 0 0 0 0 0 0 0 
0 116 41 41 85 121 121 86 0 0 0 117 118 0 113 0 0 0 0 0 0 0 
0 109 0 0 0 0 0 0 0 0 0 124 125 0 106 0 0 0 0 0 0 0 
0 109 0 0 0 0 0 0 0 0 0 0 0 0 113 0 0 0 0 0 0 0 
0 88 100 100 100 100 100 101 101 100 101 100 101 100 87 0 0 0 0 0 0 0 
0 0 0 0 0 0 0 0 0 0 0 0 0 0 0 0 0 0 0 0 0 0 
0 0 0 0 0 0 0 0 0 0 0 0 0 0 0 0 0 0 0 0 0 0